10,0,0,0,2
2,0,3,0,0
3,2,0,4,0
4,5,0,8,0
5,3,2,0,6
6,7,0,4,0
7,0,6,2,8
8,7,0,9,0
9,0,5,0,100
100,0,0,0,0
